w w w w w w w w w w w w w w w w w w w w
w k c c c c c c c c c c c c c w c c k w
w c w w c w w w c w w w w w c w c w c w
w c w w c w w w c w c c c w c w c w c w
w c w w c c c w c w c w c w c c c w c w
w c w w w w w w c w c w c w w w w w c w
w c c c w c c c O c c c O c w c c c c w
w w w c w c w w w c w w w c w c w c c w
w c c c w c w w c c c w w c w c w c c w
w c w w w O c c c w c c c c c c w c w w
w c c c c c w w c c c w w c w c w c w w
w c w w w c w w w c w w w c w c c c c w
w c w c c c c c c c c c c O w w c w c w
w c w c w w w w w O w c w w w w c w c w
w c c c c c c c c c w c c c w c c w c w
w c w c w w w w w c w c w c w c w w c w
w c w c c c w c c c w c w c w c c c c w
w c w w w c c c w w w c w c w w w w c w
w k c c c c w c c c c c w c c c c c k w
w w w w w w w w w w w w w w w w w w w w
